date,last_update,confirmed,confirmed_diff,deaths,deaths_diff,recovered,recovered_diff,active,active_diff,fatality_rate
2022-01-01,2022-01-02 04:20:52,54859966,115984,825816,280,0,0,54034150,115704,0.0151
2022-01-02,2022-01-03 02:22:25,55114057,254091,826060,244,0,0,54287997,253847,0.015
2022-01-03,2022-01-04 04:22:17,56190946,1076889,827753,1693,0,0,55363193,1075196,0.0147
2022-01-04,2022-01-05 04:21:59,57048800,857854,830071,2318,0,0,56218729,855536,0.0146
2022-01-05,2022-01-06 04:22:09,57702377,653577,832118,2047,0,0,56870259,651530,0.0144
2022-01-06,2022-01-07 04:22:09,58487665,785288,833987,1869,0,0,57653678,783419,0.0143
2022-01-07,2022-01-08 04:21:53,59388529,900864,836603,2616,0,0,58551926,898248,0.0141
2022-01-08,2022-01-09 04:21:46,59767221,378692,837262,659,0,0,58929959,378033,0.014
2022-01-09,2022-01-10 04:22:07,60072321,305100,837594,332,0,0,59234727,304768,0.0139
2022-01-10,2022-01-11 04:22:01,61558085,1485764,839500,1906,0,0,60718585,1483858,0.0136
2022-01-11,2022-01-12 04:21:44,62308132,750047,842141,2641,0,0,61465991,747406,0.0135
2022-01-12,2022-01-13 08:00:09,63203443,895311,844562,2421,0,0,62358881,892890,0.0134
2022-01-13,2022-01-14 04:21:54,64061989,858546,846463,1901,0,0,63215526,856645,0.0132
2022-01-14,2022-01-15 04:21:07,64917692,855703,849238,2775,0,0,64068454,852928,0.0131
2022-01-15,2022-01-16 04:21:12,65444262,526570,850060,822,0,0,64594202,525748,0.013
2022-01-16,2022-01-17 04:21:08,65699947,255685,850605,545,0,0,64849342,255140,0.0129
2022-01-17,2022-01-18 04:21:04,66421598,721651,851730,1125,0,0,65569868,720526,0.0128
2022-01-18,2022-01-19 04:21:23,67589830,1168232,853955,2225,0,0,66735875,1166007,0.0126
2022-01-19,2022-01-20 04:21:07,68569600,979770,857768,3813,0,0,67711832,975957,0.0125
2022-01-20,2022-01-21 04:21:09,69308071,738471,860247,2479,0,0,68447824,735992,0.0124
2022-01-21,2022-01-22 04:21:13,70209737,901666,864553,4306,0,0,69345184,897360,0.0123
2022-01-22,2022-01-23 04:21:13,70494744,285007,865968,1415,0,0,69628776,283592,0.0123
2022-01-23,2022-01-24 04:21:12,70699416,204672,866540,572,0,0,69832876,204100,0.0123
2022-01-24,2022-01-25 04:21:05,71708189,1008773,868503,1963,0,0,70839686,1006810,0.0121
2022-01-25,2022-01-26 04:21:07,72171208,463019,871937,3434,0,0,71299271,459585,0.0121
2022-01-26,2022-01-27 04:21:19,72909527,738319,876060,4123,0,0,72033467,734196,0.012
2022-01-27,2022-01-28 04:21:09,73427335,517808,878421,2361,0,0,72548914,515447,0.012
2022-01-28,2022-01-29 04:21:10,74066546,639211,882294,3873,0,0,73184252,635338,0.0119
2022-01-29,2022-01-30 04:21:26,74235709,169163,883934,1640,0,0,73351775,167523,0.0119
2022-01-30,2022-01-31 04:21:09,74332396,96687,884260,326,0,0,73448136,96361,0.0119
2022-01-31,2022-02-01 04:21:11,74941202,608806,886682,2422,0,0,74054520,606384,0.0118
2022-02-01,2022-02-02 04:21:09,75350359,409157,890770,4088,0,0,74459589,405069,0.0118
2022-02-02,2022-02-03 04:21:21,75680487,330128,894316,3546,0,0,74786171,326582,0.0118
2022-02-03,2022-02-04 04:21:10,75961961,281474,896557,2241,0,0,75065404,279233,0.0118
2022-02-04,2022-02-05 04:21:05,76354040,392079,901388,4831,0,0,75452652,387248,0.0118
2022-02-05,2022-02-06 04:21:00,76458144,104104,902266,878,0,0,75555878,103226,0.0118
2022-02-06,2022-02-07 04:21:05,76505442,47298,902624,358,0,0,75602818,46940,0.0118
2022-02-07,2022-02-08 04:21:15,76852768,347326,905539,2915,0,0,75947229,344411,0.0118
2022-02-08,2022-02-09 04:21:04,77051506,198738,908820,3281,0,0,76142686,195457,0.0118
2022-02-09,2022-02-10 04:21:14,77265134,213628,912252,3432,0,0,76352882,210196,0.0118
2022-02-10,2022-02-11 04:21:09,77428574,163440,915430,3178,0,0,76513144,160262,0.0118
2022-02-11,2022-02-12 04:21:06,77652197,223623,918451,3021,0,0,76733746,220602,0.0118
2022-02-12,2022-02-13 04:21:00,77707349,55152,919253,802,0,0,76788096,54350,0.0118
2022-02-13,2022-02-14 04:20:51,77739880,32531,919696,443,0,0,76820184,32088,0.0118
2022-02-14,2022-02-15 04:21:09,77919052,179172,922473,2777,0,0,76996579,176395,0.0118
2022-02-15,2022-02-16 04:21:10,78036352,117300,925435,2962,0,0,77110917,114338,0.0119
2022-02-16,2022-02-17 04:20:56,78171038,134686,928493,3058,0,0,77242545,131628,0.0119
2022-02-17,2022-02-18 04:21:04,78269443,98405,931741,3248,0,0,77337702,95157,0.0119
2022-02-18,2022-02-19 04:21:11,78423462,154019,934321,2580,0,0,77489141,151439,0.0119
2022-02-19,2022-02-20 04:21:00,78457081,33619,934951,630,0,0,77522130,32989,0.0119
2022-02-20,2022-02-21 04:21:05,78479134,22053,935335,384,0,0,77543799,21669,0.0119
2022-02-21,2022-02-22 04:21:01,78529099,49965,935990,655,0,0,77593109,49310,0.0119
2022-02-22,2022-02-23 04:21:09,78648651,119552,939061,3071,0,0,77709590,116481,0.0119
2022-02-23,2022-02-24 04:21:14,78733444,84793,941889,2828,0,0,77791555,81965,0.012
2022-02-24,2022-02-25 04:21:11,78798989,65545,944828,2939,0,0,77854161,62606,0.012
2022-02-25,2022-02-26 04:21:12,78883101,84112,947417,2589,0,0,77935684,81523,0.012
2022-02-26,2022-02-27 04:21:04,78931739,48638,948215,798,0,0,77983524,47840,0.012
2022-02-27,2022-02-28 04:21:05,78939203,7464,948397,182,0,0,77990806,7282,0.012
2022-02-28,2022-03-01 04:21:09,79045043,105840,950490,2093,0,0,78094553,103747,0.012
2022-03-01,2022-03-02 04:21:07,79091347,46304,952423,1933,0,0,78138924,44371,0.012
2022-03-02,2022-03-03 04:21:01,79143716,52369,954518,2095,0,0,78189198,50274,0.0121
2022-03-03,2022-03-04 04:21:09,79196008,52292,956261,1743,0,0,78239747,50549,0.0121
2022-03-04,2022-03-05 04:21:10,79250509,54501,958143,1882,0,0,78292366,52619,0.0121
2022-03-05,2022-03-06 04:20:49,79265726,15217,958437,294,0,0,78307289,14923,0.0121
2022-03-06,2022-03-07 04:20:47,79284134,18408,958840,403,0,0,78325294,18005,0.0121
2022-03-07,2022-03-08 04:20:54,79339388,55254,960505,1665,0,0,78378883,53589,0.0121
2022-03-08,2022-03-09 04:20:59,79369007,29619,961843,1338,0,0,78407164,28281,0.0121
2022-03-09,2022-03-10 04:20:48,79406602,37595,963819,1976,0,0,78442783,35619,0.0121
2022-03-10,2022-03-11 04:20:50,79454920,48318,965464,1645,0,0,78489456,46673,0.0122
2022-03-11,2022-03-12 04:20:50,79507030,52110,967165,1701,0,0,78539865,50409,0.0122
2022-03-12,2022-03-13 04:20:49,79517492,10462,967552,387,0,0,78549940,10075,0.0122
2022-03-13,2022-03-14 04:20:46,79523228,5736,967720,168,0,0,78555508,5568,0.0122
2022-03-14,2022-03-15 04:20:47,79562252,39024,965105,-2615,0,0,78597147,41639,0.0121
2022-03-15,2022-03-16 04:20:50,79586694,24442,966386,1281,0,0,78620308,23161,0.0121
2022-03-16,2022-03-17 04:20:56,79631708,45014,968329,1943,0,0,78663379,43071,0.0122
2022-03-17,2022-03-18 04:20:55,79683737,52029,970009,1680,0,0,78713728,50349,0.0122
2022-03-18,2022-03-19 04:20:47,79717247,33510,970806,797,0,0,78746441,32713,0.0122
2022-03-19,2022-03-20 04:20:45,79728165,10918,971087,281,0,0,78757078,10637,0.0122
2022-03-20,2022-03-21 04:20:50,79734788,6623,971162,75,0,0,78763626,6548,0.0122
2022-03-21,2022-03-22 04:20:54,79778889,44101,972634,1472,0,0,78806255,42629,0.0122
2022-03-22,2022-03-23 04:20:48,79803443,24554,973213,579,0,0,78830230,23975,0.0122
2022-03-23,2022-03-24 04:20:43,79844430,40987,974830,1617,0,0,78869600,39370,0.0122
2022-03-24,2022-03-25 04:20:46,79888564,44134,975838,1008,0,0,78912726,43126,0.0122
2022-03-25,2022-03-26 04:20:23,79936777,48213,976505,667,0,0,78960272,47546,0.0122
2022-03-26,2022-03-27 04:20:47,79946097,9320,976652,147,0,0,78969445,9173,0.0122
2022-03-27,2022-03-28 04:20:33,79954418,8321,976702,50,0,0,78977716,8271,0.0122
2022-03-28,2022-03-29 04:20:46,79995485,41067,977687,985,0,0,79017798,40082,0.0122
2022-03-29,2022-03-30 04:20:45,80019128,23643,978648,961,0,0,79040480,22682,0.0122
2022-03-30,2022-03-31 04:20:56,80057236,38108,979869,1221,0,0,79077367,36887,0.0122
2022-03-31,2022-04-01 04:20:28,80103661,46425,980624,755,0,0,79123037,45670,0.0122
2022-04-01,2022-04-02 04:20:47,80140309,36648,982371,1747,0,0,79157938,34901,0.0123
2022-04-02,2022-04-03 04:20:48,80150811,10502,982533,162,0,0,79168278,10340,0.0123
2022-04-03,2022-04-04 04:20:51,80155397,4586,982565,32,0,0,79172832,4554,0.0123
2022-04-04,2022-04-05 04:20:48,81495644,1340247,997127,14562,0,0,80498517,1325685,0.0122
2022-04-05,2022-04-06 04:20:49,80208810,-1286834,982576,-14551,0,0,79226234,-1272283,0.0123
2022-04-06,2022-04-07 04:20:53,80248986,40176,983817,1241,0,0,79265169,38935,0.0123
2022-04-07,2022-04-08 04:20:48,80289237,40251,984571,754,0,0,79304666,39497,0.0123
2022-04-08,2022-04-09 04:20:42,80386635,97398,985205,634,0,0,79401430,96764,0.0123
2022-04-09,2022-04-10 04:20:52,80399486,12851,985482,277,0,0,79414004,12574,0.0123
2022-04-10,2022-04-11 04:21:02,80396250,-3236,985504,22,0,0,79410746,-3258,0.0123
2022-04-11,2022-04-12 04:20:49,80449944,53694,985826,322,0,0,79464118,53372,0.0123
2022-04-12,2022-04-13 04:21:03,80477797,27853,986387,561,0,0,79491410,27292,0.0123
2022-04-13,2022-04-13 23:21:06,80518050,40253,987331,944,0,0,79530719,39309,0.0123
2022-04-14,2022-04-15 04:20:57,80573532,55482,988121,790,0,0,79585411,54692,0.0123
2022-04-15,2022-04-16 04:20:48,80612681,39149,988558,437,0,0,79624123,38712,0.0123
2022-04-16,2022-04-17 04:20:59,80625120,12439,988609,51,0,0,79636511,12388,0.0123
2022-04-17,2022-04-18 04:21:12,80632301,7181,988618,9,0,0,79643683,7172,0.0123
2022-04-18,2022-04-19 04:21:00,80686310,54009,988899,281,0,0,79697411,53728,0.0123
2022-04-19,2022-04-20 04:20:45,80732932,46622,989331,432,0,0,79743601,46190,0.0123
2022-04-20,2022-04-21 04:20:46,80801713,68781,990208,877,0,0,79811505,67904,0.0123
2022-04-21,2022-04-22 04:20:45,80850913,49200,990679,471,0,0,79860234,48729,0.0123
2022-04-22,2022-04-23 04:20:50,80952268,101355,991169,490,0,0,79961099,100865,0.0122
2022-04-23,2022-04-24 04:20:56,80971930,19662,991231,62,0,0,79980699,19600,0.0122
2022-04-24,2022-04-25 04:20:56,80984914,12984,991254,23,0,0,79993660,12961,0.0122
2022-04-25,2022-04-26 04:20:51,81043103,58189,991609,355,0,0,80051494,57834,0.0122
2022-04-26,2022-04-27 04:20:52,81100599,57496,991940,331,0,0,80108659,57165,0.0122
2022-04-27,2022-04-28 04:20:47,81189379,88780,992740,800,0,0,80196639,87980,0.0122
2022-04-28,2022-04-29 04:20:59,81251631,62252,993164,424,0,0,80258467,61828,0.0122
2022-04-29,2022-04-30 04:21:05,81325716,74085,993588,424,0,0,80332128,73661,0.0122
2022-04-30,2022-05-01 04:20:57,81349065,23349,993712,124,0,0,80355353,23225,0.0122
2022-05-01,2022-05-02 04:21:10,81365218,16153,993733,21,0,0,80371485,16132,0.0122
2022-05-02,2022-05-03 04:21:00,81444332,79114,993999,266,0,0,80450333,78848,0.0122
2022-05-03,2022-05-04 04:20:59,81506075,61743,994744,745,0,0,80511331,60998,0.0122
2022-05-04,2022-05-05 04:20:55,81620383,114308,996704,1960,0,0,80623679,112348,0.0122
2022-05-05,2022-05-06 04:21:00,81692541,72158,996946,242,0,0,80695595,71916,0.0122
2022-05-06,2022-05-07 04:21:09,81831854,139313,997318,372,0,0,80834536,138941,0.0122
2022-05-07,2022-05-08 04:20:49,81858744,26890,997503,185,0,0,80861241,26705,0.0122
2022-05-08,2022-05-09 04:20:54,81863725,4981,997526,23,0,0,80866199,4958,0.0122
2022-05-09,2022-05-10 04:20:50,81973661,109936,998040,514,0,0,80975621,109422,0.0122
2022-05-10,2022-05-11 04:20:48,82059839,86178,998048,8,0,0,81061791,86170,0.0122
2022-05-11,2022-05-12 04:20:54,82223174,163335,998997,949,0,0,81224177,162386,0.0121
2022-05-12,2022-05-13 04:20:51,82325687,102513,999125,128,0,0,81326562,102385,0.0121
2022-05-13,2022-05-14 04:20:48,82421624,95937,999518,393,0,0,81422106,95544,0.0121
2022-05-14,2022-05-15 04:20:53,82437716,16092,999570,52,0,0,81438146,16040,0.0121
2022-05-15,2022-05-16 04:20:47,82468606,30890,999602,32,0,0,81469004,30858,0.0121
2022-05-16,2022-05-17 04:20:59,82613620,145014,999842,240,0,0,81613778,144774,0.0121
2022-05-17,2022-05-18 04:20:50,82726107,112487,1000189,347,0,0,81725918,112140,0.0121
2022-05-18,2022-05-19 04:20:54,82951379,225272,1001269,1080,0,0,81950110,224192,0.0121
2022-05-19,2022-05-20 04:20:57,83060959,109580,1001606,337,0,0,82059353,109243,0.0121
2022-05-20,2022-05-21 04:20:58,83237592,176633,1002020,414,0,0,82235572,176219,0.012
2022-05-21,2022-05-22 04:20:52,83263020,25428,1002146,126,0,0,82260874,25302,0.012
2022-05-22,2022-05-23 04:20:49,83281329,18309,1002173,27,0,0,82279156,18282,0.012
2022-05-23,2022-05-24 04:20:57,83390587,109258,1002377,204,0,0,82388210,109054,0.012
2022-05-24,2022-05-25 04:20:56,83501457,110870,1002726,349,0,0,82498731,110521,0.012
2022-05-25,2022-05-26 04:20:50,83706662,205205,1003743,1017,0,0,82702919,204188,0.012
2022-05-26,2022-05-27 04:20:56,83837114,130452,1004121,378,0,0,82832993,130074,0.012
2022-05-27,2022-05-28 04:21:07,83969313,132199,1004693,572,0,0,82964620,131627,0.012
2022-05-28,2022-05-29 04:20:53,83980356,11043,1004726,33,0,0,82975630,11010,0.012
2022-05-29,2022-05-30 04:20:50,83984644,4288,1004733,7,0,0,82979911,4281,0.012
2022-05-30,2022-05-31 04:20:51,84012408,27764,1004760,27,0,0,83007648,27737,0.012
2022-05-31,2022-06-01 04:20:55,84210808,198400,1007032,2272,0,0,83203776,196128,0.012
2022-06-01,2022-06-02 14:20:54,84449947,239139,1007719,687,0,0,83442228,238452,0.0119
2022-06-02,2022-06-03 04:20:58,84545475,95528,1008031,312,0,0,83537444,95216,0.0119
2022-06-03,2022-06-04 04:20:58,84724329,178854,1008422,391,0,0,83715907,178463,0.0119
2022-06-04,2022-06-05 04:20:55,84748884,24555,1008567,145,0,0,83740317,24410,0.0119
2022-06-05,2022-06-06 04:20:57,84762022,13138,1008585,18,0,0,83753437,13120,0.0119
2022-06-06,2022-06-07 04:21:08,84882287,120265,1008857,272,0,0,83873430,119993,0.0119
2022-06-07,2022-06-08 04:20:55,85003945,121658,1009326,469,0,0,83994619,121189,0.0119
2022-06-08,2022-06-09 04:20:54,85214036,210091,1010520,1194,0,0,84203516,208897,0.0119
2022-06-09,2022-06-10 04:20:55,85329656,115620,1010805,285,0,0,84318851,115335,0.0118
2022-06-10,2022-06-11 04:21:01,85468816,139160,1011164,359,0,0,84457652,138801,0.0118
2022-06-11,2022-06-12 04:20:53,85500976,32160,1011260,96,0,0,84489716,32064,0.0118
2022-06-12,2022-06-13 04:21:14,85515795,14819,1011275,15,0,0,84504520,14804,0.0118
2022-06-13,2022-06-14 04:20:52,85632808,117013,1011543,268,0,0,84621265,116745,0.0118
2022-06-14,2022-06-15 04:20:54,85758638,125830,1011925,382,0,0,84746713,125448,0.0118
2022-06-15,2022-06-16 04:20:55,85941735,183097,1012607,682,0,0,84929128,182415,0.0118
2022-06-16,2022-06-17 04:20:56,86058180,116445,1012647,40,0,0,85045533,116405,0.0118
2022-06-17,2022-06-18 04:21:10,86216418,158238,1013358,711,0,0,85203060,157527,0.0118
2022-06-18,2022-06-19 04:20:51,86230982,14564,1013377,19,0,0,85217605,14545,0.0118
2022-06-19,2022-06-20 04:21:01,86246101,15119,1013413,36,0,0,85232688,15083,0.0118
2022-06-20,2022-06-21 04:20:56,86297081,50980,1013493,80,0,0,85283588,50900,0.0117
2022-06-21,2022-06-22 04:20:54,86452232,155151,1013975,482,0,0,85438257,154669,0.0117
2022-06-22,2022-06-23 04:20:55,86636306,184074,1014835,860,0,0,85621471,183214,0.0117
2022-06-23,2022-06-24 04:20:58,86757621,121315,1015342,507,0,0,85742279,120808,0.0117
2022-06-24,2022-06-25 04:20:57,86909716,152095,1015789,447,0,0,85893927,151648,0.0117
2022-06-25,2022-06-26 04:21:02,86949088,39372,1015933,144,0,0,85933155,39228,0.0117
2022-06-26,2022-06-27 04:21:00,86967639,18551,1015938,5,0,0,85951701,18546,0.0117
2022-06-27,2022-06-28 04:20:58,87092233,124594,1016208,270,0,0,86076025,124324,0.0117
2022-06-28,2022-06-29 04:20:59,87217673,125440,1016757,549,0,0,86200916,124891,0.0117
2022-06-29,2022-06-30 04:21:01,87410874,193201,1017467,710,0,0,86393407,192491,0.0116
2022-06-30,2022-07-01 04:21:10,87623593,212719,1017266,-201,0,0,86606327,212920,0.0116
2022-07-01,2022-07-02 04:21:16,87821971,198378,1017817,551,0,0,86804154,197827,0.0116
2022-07-02,2022-07-03 04:20:59,87838623,16652,1017846,29,0,0,86820777,16623,0.0116
2022-07-03,2022-07-04 04:20:54,87843561,4938,1017848,2,0,0,86825713,4936,0.0116
2022-07-04,2022-07-05 04:20:45,87886589,43028,1017915,67,0,0,86868674,42961,0.0116
2022-07-05,2022-07-06 04:20:58,88066096,179507,1018349,434,0,0,87047747,179073,0.0116
2022-07-06,2022-07-07 04:20:55,88263393,197297,1019083,734,0,0,87244310,196563,0.0115
2022-07-07,2022-07-08 04:20:56,88381589,118196,1020262,1179,0,0,87361327,117017,0.0115
2022-07-08,2022-07-09 04:20:59,88547882,166293,1020816,554,0,0,87527066,165739,0.0115
2022-07-09,2022-07-10 04:20:54,88572807,24925,1020852,36,0,0,87551955,24889,0.0115
2022-07-10,2022-07-11 04:20:46,88593875,21068,1020861,9,0,0,87573014,21059,0.0115
2022-07-11,2022-07-12 04:20:51,88754821,160946,1021306,445,0,0,87733515,160501,0.0115
2022-07-12,2022-07-13 04:20:58,88946276,191455,1021838,532,0,0,87924438,190923,0.0115
2022-07-13,2022-07-14 04:20:57,89221950,275674,1023619,1781,0,0,88198331,273893,0.0115
2022-07-14,2022-07-15 04:20:53,89294234,72284,1024051,432,0,0,88270183,71852,0.0115
2022-07-15,2022-07-16 04:21:05,89453076,158842,1023736,-315,0,0,88429340,159157,0.0114
2022-07-16,2022-07-17 04:21:15,89521016,67940,1023788,52,0,0,88497228,67888,0.0114
2022-07-17,2022-07-18 04:20:59,89542107,21091,1023799,11,0,0,88518308,21080,0.0114
2022-07-18,2022-07-19 04:20:58,89677127,135020,1024266,467,0,0,88652861,134553,0.0114
2022-07-19,2022-07-20 04:20:59,89830640,153513,1024858,592,0,0,88805782,152921,0.0114
2022-07-20,2022-07-21 04:21:10,90046834,216194,1025741,883,0,0,89021093,215311,0.0114
2022-07-21,2022-07-22 04:21:15,90200438,153604,1026294,553,0,0,89174144,153051,0.0114
2022-07-22,2022-07-23 04:20:53,90367064,166626,1026883,589,0,0,89340181,166037,0.0114
2022-07-23,2022-07-24 04:20:47,90390185,23121,1026937,54,0,0,89363248,23067,0.0114
2022-07-24,2022-07-25 04:20:51,90410386,20201,1026951,14,0,0,89383435,20187,0.0114
2022-07-25,2022-07-26 04:20:58,90567290,156904,1027369,418,0,0,89539921,156486,0.0113
2022-07-26,2022-07-27 04:21:04,90733888,166598,1027886,517,0,0,89706002,166081,0.0113
2022-07-27,2022-07-28 04:20:56,90973418,239530,1028819,933,0,0,89944599,238597,0.0113
2022-07-28,2022-07-29 04:20:45,91120218,146800,1029270,451,0,0,90090948,146349,0.0113
2022-07-29,2022-07-30 04:20:42,91300271,180053,1029903,633,0,0,90270368,179420,0.0113
2022-07-30,2022-07-31 04:21:02,91309159,8888,1029925,22,0,0,90279234,8866,0.0113
2022-07-31,2022-08-01 04:21:03,91316648,7489,1029926,1,0,0,90286722,7488,0.0113
2022-08-01,2022-08-02 04:20:53,91472835,156187,1030498,572,0,0,90442337,155615,0.0113
2022-08-02,2022-08-03 04:20:59,91585521,112686,1030962,464,0,0,90554559,112222,0.0113
2022-08-03,2022-08-04 04:20:58,91794811,209290,1032097,1135,0,0,90762714,208155,0.0112
2022-08-04,2022-08-05 04:20:52,91961519,166708,1032820,723,0,0,90928699,165985,0.0112
2022-08-05,2022-08-06 04:20:56,92090455,128936,1033516,696,0,0,91056939,128240,0.0112
2022-08-06,2022-08-07 04:20:54,92197380,106925,1034152,636,0,0,91163228,106289,0.0112
2022-08-07,2022-08-08 04:21:08,92112922,-84458,1033556,-596,0,0,91079366,-83862,0.0112
2022-08-08,2022-08-09 04:20:34,92241199,128277,1034020,464,0,0,91207179,127813,0.0112
2022-08-09,2022-08-10 04:20:57,92341611,100412,1034621,601,0,0,91306990,99811,0.0112
2022-08-10,2022-08-11 04:20:49,92562177,220566,1035548,927,0,0,91526629,219639,0.0112
2022-08-11,2022-08-12 04:20:54,92719491,157314,1036325,777,0,0,91683166,156537,0.0112
2022-08-12,2022-08-13 04:20:52,92838677,119186,1036990,665,0,0,91801687,118521,0.0112
2022-08-13,2022-08-14 04:20:55,92919750,81073,1037017,27,0,0,91882733,81046,0.0112
2022-08-14,2022-08-15 04:20:59,92927104,7354,1037021,4,0,0,91890083,7350,0.0112
2022-08-15,2022-08-16 04:20:58,93026647,99543,1037461,440,0,0,91989186,99103,0.0112
2022-08-16,2022-08-17 04:20:59,93140979,114332,1037935,474,0,0,92103044,113858,0.0111
2022-08-17,2022-08-18 04:21:11,93278036,137057,1039026,1091,0,0,92239010,135966,0.0111
2022-08-18,2022-08-19 04:20:54,93403142,125106,1039746,720,0,0,92363396,124386,0.0111
2022-08-19,2022-08-20 04:21:01,93500945,97803,1040355,609,0,0,92460590,97194,0.0111
2022-08-20,2022-08-21 04:20:44,93634408,133463,1041141,786,0,0,92593267,132677,0.0111
2022-08-21,2022-08-22 04:20:38,93641944,7536,1041149,8,0,0,92600795,7528,0.0111
2022-08-22,2022-08-23 04:20:56,93623893,-18051,1040898,-251,0,0,92582995,-17800,0.0111
2022-08-23,2022-08-24 04:20:46,93754248,130355,1041466,568,0,0,92712782,129787,0.0111
2022-08-24,2022-08-25 04:21:13,93903884,149636,1042398,932,0,0,92861486,148704,0.0111
2022-08-25,2022-08-26 04:21:02,94028125,124241,1043089,691,0,0,92985036,123550,0.0111
2022-08-26,2022-08-27 04:20:57,94171060,142935,1043783,694,0,0,93127277,142241,0.0111
2022-08-27,2022-08-28 04:21:02,94184146,13086,1043838,55,0,0,93140308,13031,0.0111
2022-08-28,2022-08-29 04:21:06,94190979,6833,1043840,2,0,0,93147139,6831,0.0111
2022-08-29,2022-08-30 04:21:03,94280272,89293,1044332,492,0,0,93235940,88801,0.0111
2022-08-30,2022-08-31 04:20:57,94379514,99242,1044730,398,0,0,93334784,98844,0.0111
2022-08-31,2022-09-01 04:21:03,94532122,152608,1046243,1513,0,0,93485879,151095,0.0111
2022-09-01,2022-09-02 04:21:07,94649469,117347,1047006,763,0,0,93602463,116584,0.0111
2022-09-02,2022-09-03 04:21:04,94732814,83345,1047478,472,0,0,93685336,82873,0.0111
2022-09-03,2022-09-04 04:21:22,94742293,9479,1047497,19,0,0,93694796,9460,0.0111
2022-09-04,2022-09-05 04:21:01,94748404,6111,1047498,1,0,0,93700906,6110,0.0111
2022-09-05,2022-09-06 04:21:02,94768178,19774,1047563,65,0,0,93720615,19709,0.0111
2022-09-06,2022-09-07 04:20:59,94880701,112523,1048186,623,0,0,93832515,111900,0.011
2022-09-07,2022-09-08 04:21:02,95020834,140133,1048989,803,0,0,93971845,139330,0.011
2022-09-08,2022-09-09 04:21:11,95118482,97648,1049749,760,0,0,94068733,96888,0.011
2022-09-09,2022-09-10 04:21:10,95224801,106319,1050290,541,0,0,94174511,105778,0.011
2022-09-10,2022-09-11 04:20:50,95242750,17949,1050318,28,0,0,94192432,17921,0.011
2022-09-11,2022-09-12 04:20:58,95250705,7955,1050323,5,0,0,94200382,7950,0.011
2022-09-12,2022-09-13 04:20:57,95320071,69366,1050767,444,0,0,94269304,68922,0.011
2022-09-13,2022-09-14 04:20:44,95387377,67306,1051277,510,0,0,94336100,66796,0.011
2022-09-14,2022-09-15 04:21:02,95490495,103118,1052214,937,0,0,94438281,102181,0.011
2022-09-15,2022-09-16 04:21:19,95585465,94970,1052939,725,0,0,94532526,94245,0.011
2022-09-16,2022-09-17 04:20:19,95645794,60329,1053389,450,0,0,94592405,59879,0.011
2022-09-17,2022-09-18 04:22:50,95653526,7732,1053412,23,0,0,94600114,7709,0.011
2022-09-18,2022-09-19 04:21:49,95658236,4710,1053419,7,0,0,94604817,4703,0.011
2022-09-19,2022-09-20 04:22:48,95713363,55127,1053840,421,0,0,94659523,54706,0.011
2022-09-20,2022-09-21 04:23:22,95776398,63035,1054271,431,0,0,94722127,62604,0.011
2022-09-21,2022-09-22 04:22:56,95874591,98193,1055195,924,0,0,94819396,97269,0.011
2022-09-22,2022-09-23 04:23:13,95969895,95304,1055922,727,0,0,94913973,94577,0.011
2022-09-23,2022-09-24 04:21:40,96056075,86180,1056372,450,0,0,94999703,85730,0.011
2022-09-24,2022-09-25 04:23:31,96065161,9086,1056409,37,0,0,95008752,9049,0.011
2022-09-25,2022-09-26 04:20:52,96070980,5819,1056416,7,0,0,95014564,5812,0.011
2022-09-26,2022-09-27 04:23:01,96116204,45224,1056789,373,0,0,95059415,44851,0.011
2022-09-27,2022-09-28 04:23:01,96162907,46703,1057247,458,0,0,95105660,46245,0.011
2022-09-28,2022-09-29 04:22:34,96249166,86259,1058506,1259,0,0,95190660,85000,0.011
2022-09-29,2022-09-30 04:23:09,96346995,97829,1059288,782,0,0,95287707,97047,0.011
2022-09-30,2022-10-01 04:23:01,96385048,38053,1059579,291,0,0,95325469,37762,0.011
2022-10-01,2022-10-02 04:21:23,96392543,7495,1059605,26,0,0,95332938,7469,0.011
2022-10-02,2022-10-03 04:23:11,96397885,5342,1059605,0,0,0,95338280,5342,0.011
2022-10-03,2022-10-04 04:22:55,96438726,40841,1059866,261,0,0,95378860,40580,0.011
2022-10-04,2022-10-05 04:23:06,96481081,42355,1060408,542,0,0,95420673,41813,0.011
2022-10-05,2022-10-06 04:21:22,96552187,71106,1061490,1082,0,0,95490697,70024,0.011
2022-10-06,2022-10-07 04:23:08,96612478,60291,1062130,640,0,0,95550348,59651,0.011
2022-10-07,2022-10-08 04:22:56,96686904,74426,1062513,383,0,0,95624391,74043,0.011
2022-10-08,2022-10-09 04:21:16,96694214,7310,1062560,47,0,0,95631654,7263,0.011
2022-10-09,2022-10-10 04:22:32,96699237,5023,1062564,4,0,0,95636673,5019,0.011
2022-10-10,2022-10-11 04:23:05,96721113,21876,1062681,117,0,0,95658432,21759,0.011
2022-10-11,2022-10-12 04:22:51,96772268,51155,1063310,629,0,0,95708958,50526,0.011
2022-10-12,2022-10-13 04:22:39,96836953,64685,1064058,748,0,0,95772895,63937,0.011
2022-10-13,2022-10-14 04:22:28,96911257,74304,1064798,740,0,0,95846459,73564,0.011
2022-10-14,2022-10-15 04:22:00,96940217,28960,1065076,278,0,0,95875141,28682,0.011
2022-10-15,2022-10-16 04:22:39,96945785,5568,1065108,32,0,0,95880677,5536,0.011
2022-10-16,2022-10-17 04:20:31,96952191,6406,1065109,1,0,0,95887082,6405,0.011
2022-10-17,2022-10-18 04:22:42,96990467,38276,1065441,332,0,0,95925026,37944,0.011
2022-10-18,2022-10-19 04:22:26,97023298,32831,1065841,400,0,0,95957457,32431,0.011
2022-10-19,2022-10-20 04:22:59,97083662,60364,1066584,743,0,0,96017078,59621,0.011
2022-10-20,2022-10-21 04:22:23,97150292,66630,1067190,606,0,0,96083102,66024,0.011
2022-10-21,2022-10-22 04:22:53,97185559,35267,1067673,483,0,0,96117886,34784,0.011
2022-10-22,2022-10-23 04:22:46,97190530,4971,1067685,12,0,0,96122845,4959,0.011
2022-10-23,2022-10-24 04:22:29,97198630,8100,1067686,1,0,0,96130944,8099,0.011
2022-10-24,2022-10-25 04:21:53,97239469,40839,1067882,196,0,0,96171587,40643,0.011
2022-10-25,2022-10-26 04:22:19,97268173,28704,1068297,415,0,0,96199876,28289,0.011
2022-10-26,2022-10-27 04:22:01,97343426,75253,1069449,1152,0,0,96273977,74101,0.011
2022-10-27,2022-10-28 04:22:31,97409772,66346,1070055,606,0,0,96339717,65740,0.011
2022-10-28,2022-10-29 04:21:13,97438900,29128,1070234,179,0,0,96368666,28949,0.011
2022-10-29,2022-10-30 04:22:14,97447532,8632,1070263,29,0,0,96377269,8603,0.011
2022-10-30,2022-10-31 04:21:36,97450639,3107,1070266,3,0,0,96380373,3104,0.011
2022-10-31,2022-11-01 04:22:36,97495076,44437,1070389,123,0,0,96424687,44314,0.011
2022-11-01,2022-11-02 04:22:09,97531408,36332,1070788,399,0,0,96460620,35933,0.011
2022-11-02,2022-11-03 04:22:05,97611400,79992,1071578,790,0,0,96539822,79202,0.011
2022-11-03,2022-11-04 04:22:11,97691083,79683,1072222,644,0,0,96618861,79039,0.011
2022-11-04,2022-11-05 04:21:52,97729653,38570,1072561,339,0,0,96657092,38231,0.011
2022-11-05,2022-11-06 04:21:24,97734261,4608,1072582,21,0,0,96661679,4587,0.011
2022-11-06,2022-11-07 04:21:26,97741764,7503,1072594,12,0,0,96669170,7491,0.011
2022-11-07,2022-11-08 04:21:21,97780182,38418,1072724,130,0,0,96707458,38288,0.011
2022-11-08,2022-11-09 04:21:22,97797561,17379,1072921,197,0,0,96724640,17182,0.011
2022-11-09,2022-11-10 04:21:16,97900497,102936,1073932,1011,0,0,96826565,101925,0.011
2022-11-10,2022-11-11 04:21:22,97977357,76860,1074485,553,0,0,96902872,76307,0.011
2022-11-11,2022-11-12 04:20:41,97990681,13324,1074524,39,0,0,96916157,13285,0.011
2022-11-12,2022-11-13 04:21:14,97995355,4674,1074484,-40,0,0,96920871,4714,0.011
2022-11-13,2022-11-14 04:21:09,97997389,2034,1074485,1,0,0,96922904,2033,0.011
2022-11-14,2022-11-15 04:21:16,98045358,47969,1074688,203,0,0,96970670,47766,0.011
2022-11-15,2022-11-16 04:21:09,98086072,40714,1075088,400,0,0,97010984,40314,0.011
2022-11-16,2022-11-17 04:21:11,98175726,89654,1075951,863,0,0,97099775,88791,0.011
2022-11-17,2022-11-18 04:21:15,98245940,70214,1076492,541,0,0,97169448,69673,0.011
2022-11-18,2022-11-19 04:21:14,98301472,55532,1077020,528,0,0,97224452,55004,0.011
2022-11-19,2022-11-20 04:21:08,98305722,4250,1077031,11,0,0,97228691,4239,0.011
2022-11-20,2022-11-21 04:21:05,98308990,3268,1077031,0,0,0,97231959,3268,0.011
2022-11-21,2022-11-22 04:20:47,98351547,42557,1077225,194,0,0,97274322,42363,0.011
2022-11-22,2022-11-23 04:21:06,98386225,34678,1077777,552,0,0,97308448,34126,0.011
2022-11-23,2022-11-24 04:21:09,98503462,117237,1078929,1152,0,0,97424533,116085,0.011
2022-11-24,2022-11-25 04:21:06,98538245,34783,1079052,123,0,0,97459193,34660,0.011
2022-11-25,2022-11-26 04:21:11,98562304,24059,1079196,144,0,0,97483108,23915,0.0109
2022-11-26,2022-11-27 04:21:05,98564494,2190,1079197,1,0,0,97485297,2189,0.0109
2022-11-27,2022-11-28 04:21:02,98568849,4355,1079197,0,0,0,97489652,4355,0.0109
2022-11-28,2022-11-29 04:21:05,98628566,59717,1079477,280,0,0,97549089,59437,0.0109
2022-11-29,2022-11-30 04:21:07,98673988,45422,1079870,393,0,0,97594118,45029,0.0109
2022-11-30,2022-12-01 04:21:03,98788140,114152,1080444,574,0,0,97707696,113578,0.0109
2022-12-01,2022-12-02 04:21:07,98923115,134975,1081147,703,0,0,97841968,134272,0.0109
2022-12-02,2022-12-03 04:21:02,98962019,38904,1081412,265,0,0,97880607,38639,0.0109
2022-12-03,2022-12-04 04:20:56,98967906,5887,1081431,19,0,0,97886475,5868,0.0109
2022-12-04,2022-12-05 04:20:58,98972375,4469,1081431,0,0,0,97890944,4469,0.0109
2022-12-05,2022-12-06 04:21:03,99023619,51244,1081638,207,0,0,97941981,51037,0.0109
2022-12-06,2022-12-07 04:20:58,99077996,54377,1082224,586,0,0,97995772,53791,0.0109
2022-12-07,2022-12-08 04:21:07,99230740,152744,1083362,1138,0,0,98147378,151606,0.0109
2022-12-08,2022-12-09 04:21:05,99365270,134530,1084236,874,0,0,98281034,133656,0.0109
2022-12-09,2022-12-10 04:21:02,99402420,37150,1084422,186,0,0,98317998,36964,0.0109
2022-12-10,2022-12-11 04:20:50,99408565,6145,1084439,17,0,0,98324126,6128,0.0109
2022-12-11,2022-12-12 04:21:01,99413504,4939,1084439,0,0,0,98329065,4939,0.0109
2022-12-12,2022-12-13 04:21:01,99470198,56694,1084651,212,0,0,98385547,56482,0.0109
2022-12-13,2022-12-14 04:21:04,99526290,56092,1085224,573,0,0,98441066,55519,0.0109
2022-12-14,2022-12-15 04:20:58,99682155,155865,1086199,975,0,0,98595956,154890,0.0109
2022-12-15,2022-12-16 04:21:01,99826698,144543,1087013,814,0,0,98739685,143729,0.0109
2022-12-16,2022-12-17 04:21:04,99881898,55200,1087398,385,0,0,98794500,54815,0.0109
2022-12-17,2022-12-18 04:21:03,99887614,5716,1087410,12,0,0,98800204,5704,0.0109
2022-12-18,2022-12-19 04:21:03,99892513,4899,1087410,0,0,0,98805103,4899,0.0109
2022-12-19,2022-12-20 04:21:04,99950486,57973,1087672,262,0,0,98862814,57711,0.0109
2022-12-20,2022-12-21 04:21:03,100003814,53328,1088236,564,0,0,98915578,52764,0.0109
2022-12-21,2022-12-22 04:20:56,100184506,180692,1089340,1104,0,0,99095166,179588,0.0109
2022-12-22,2022-12-23 04:21:04,100303927,119421,1090014,674,0,0,99213913,118747,0.0109
2022-12-23,2022-12-24 04:21:02,100365943,62016,1090200,186,0,0,99275743,61830,0.0109
2022-12-24,2022-12-25 04:21:04,100371552,5609,1090204,4,0,0,99281348,5605,0.0109
2022-12-25,2022-12-26 04:21:06,100374019,2467,1090204,0,0,0,99283815,2467,0.0109
2022-12-26,2022-12-27 04:21:07,100384972,10953,1090218,14,0,0,99294754,10939,0.0109
2022-12-27,2022-12-28 04:21:04,100469001,84029,1090561,343,0,0,99378440,83686,0.0109
2022-12-28,2022-12-29 04:21:01,100582834,113833,1091474,913,0,0,99491360,112920,0.0109
2022-12-29,2022-12-30 04:21:04,100706571,123737,1092456,982,0,0,99614115,122755,0.0108
2022-12-30,2022-12-31 04:20:54,100743442,36871,1092661,205,0,0,99650781,36666,0.0108
2022-12-31,2023-01-01 04:21:00,100749731,6289,1092674,13,0,0,99657057,6276,0.0108
